...................................................................................................................................
..............#............#..#......#.##.....#..##..##.#...............#.........#......#....#..#.......#............#.#..........
.......##.......#..#..................#.......#...#..##.##.................##......#.......#..#.....##........##..#.....#......###.
.......#...#..#...........#............#..#..........#.#..#................#.....#......#.................###.....#.#....#.........
...........#......#....#...#...#........#.............#....................#......#...............#..#..........#..............#...
...#.#..#.#............................#.....##........#........#..................#.#....##.............#.##...#......###.........
..#......#.........#...........#....#.....#..........#.................................#.................#............#..#......##.
.##...#...#....#................#.#.#.....#..................................................#...#.....#...#..#...............##...
.......#.............#.#..#........#.#...........#.#............#..#...........##.#....##...........#.........#..#.....#...........
......#......#...............#........#.....#...##.#...........................#....#..#.#......#....#.....#...#....#.........#....
..................##.#.......#.....#.......#......#...........#.#...............#.....#.##..#....#....#..............#.#..#...#....
...........#..........#......................#.............#...##......##...............#.......##.......#.......#..#....#.........
.....#..................#............#...#.......#...........#.......#................#..#...#....#.......##...#.....#........#....
...#...........#..............##...##.....#.#..#...............#....................#.......#..#..#.....#..#...#.............#..#..
.#......#.......................#......#.#..#.#...............#...............................#.#..#......#..........#....#....#...
..........#........#.........##.#...#.....................#.......#...#...............#...#..#......#..#.#........#...#...#........
.##.....#..#...............#............................#.............#..................#.....#...#.#....#......#.....#...........
....#...#..#.##.#........#..#.............................#..............#....#............#.....#.....#.#...#...#.......#....#.#..
......#.......#..#........#...........##............#.....##...##.............#........#....................#......#.......#.......
.#......#............#...#..#..#..##..................#...#...............#...............#.............#..#..#.##..#......#..#....
............#.............#...#.......#..........#....#..##....#...#...#.#.....#..............#...#....##..........................
...##...#.......#........#.#...#....#...#................................#.....#.#........#.......#.....#..........................
.#......#.......#...##.#..##.......#.......................#.#.....#.......................#.....#.......#.........#..........#.#..
.........#...........#...........................#.........##.......#......##..#............#..#.........#.......#....#............
......................#....##..................#.......#..........#..#...#.##.#.....................#.#...#....#.......#.......##..
..##.##...........#....#...#...#..#.#........##.....#.........#...#......#.#........#.............................#...#............
...........###...#..##.....#..................................#....##........#.#....#..............#...#..##.....#.....#......#..#.
....#....##.#........#.........##...............#............#....#..........#.....................#................#.#............
.#..##.#....#...............##.#.............#..#..............#......###.....#.#......................#.....##.........##.......#.
...#............#.......#..#...#...........#........#....#......#..............#.....................#..#..........................
.#...................#........#.........#.#.................#............#............#.#..................#...#....#....#.........
.......#..#........#..........#..........#.#.....#..##.........#..............#......#........................##.....#.#...........
............#.............................###........#.........#...#......#...#.#.....#...............#....##...#....##..##....#...
....#...#.##.......#.#..............##..................###..##......#........#.....#.#...................#...#......#........#..#.
..............##...#....##................###....###.#...#........#.....#..................#..............#...#.....#...#..........
..##......#.##......##....#........#...#..#...#............#...#....#..#.............#........#..................#........#........
..#....................#.#........#....#.....................#............#......#...#.....##.............#..........#..........#..
.........#...##..#........................#.##.....#...............#..##...#.....#..#............................#...#..##.#.....#.
.......................#........#.#.........#..#.......##..........................#..#.....#..................##..................
...............#...............#...#.........##......#.........#..#......#..#.........#....#...................#..#.#...###........
..#.#...#..#......##.......................#...#......#..............#......................#..#...............##..................
...........#.................#.....#..........##.........#..........#.....#............#....#.........................#.....#......
.........#..##....#..............#...#..........#......#..#.#.#..........#..#....#............##..#............#........#.#....#...
.....#.#..###....#.........#...#.....#........#..#.....##...#......#.................##...............#................#.....#.....
.......#....#..............#.#...#........#.....#...............#..#..#................#.........#...................##.....#......
......#...#.................#.#...........#.#.................................#.#.##.......#......#...#..#...................#.##..
..#...........#........#...#...#.....#...#.......#........##...#.......#...................................#..........#............
......#..#..#..........#..#...#......#..............#..#....#.....#.#....#........#.###.......#..#.#.....................#...#.....
..#..................#..#........#...#..........#..#.#....#...........#.#...#...#..#..#.#........#..#.......##...................#.
..#......##.............#.........#......#.##...##.#.#...#...........#.........#.##...#..#.....#...#....#..........................
................................##............#..#.............#...........#........#.##.......#.#...#..#...#.#........#.......#...
..........................#.........................#..........#....#.....#......#.#.......#.#..#.....#.....#..#.................#.
...#.............#...#...#...#...#.....#.........#.................#...##.....#......................#.....#.#.#.........##....#...
.....#...........#.##.#...#...#.#.#....#......#...#..#..#...#...#.#.#.#.##.......#.........#..........#...................#....##..
......#..................##..##.#.......#..............#.#...............#.#...#...##.......#.......#.....#....#...............#...
...#.........................#........##........#....#...#.....#....................#......#..#...........#.#.##..............#....
.............#........#....####..##..........#.#..............#...#............#.............##...####..........##...........##....
................#.....##..........#........#..##.#................#.......#.##....#.......#..#...##......##........................
.#.........#...#.......#.#.#....#.....#..................##.#.......#......#......#....#.......#...#.....#...#.....#...#.......#...
..........#...#..............#....#..#..#...............##.....#.......#...............#................#.#.#.#.........#..........
..............#.#...........#.......#............#..#..#.#..............#....#..##.#.#........#...#................#...#.#.........
.................................#............#...#................#...#......#.#...#..#............#............#.................
..............##....#........#............#.#...#.#....#...##..##........#.#.#....................#.#..........#.#....#....#.......
..........#.......#...#...#...#.#..#..#......#.......#..........#.........#..#.....................#........#....#..#.....#........
.....#....#........................#...#.#..#.....#...#.#.........#..........#.....#..#..#..###..#..............#..................
.................................................................S.................................................................
...............#................#.........#....#.#...........##.....#........................#.......#..#.#.....###..##.#..........
..........#....#........#...#..#.......#.#.........#.........#..#.....###......#.........#...#........#....#...#....##.............
.......##..............#........##.........#........#..#.#......#..........#........#....#............##.#........#....#..#........
.........##...........#....#.#.....#.........#.#....#.....##..#.....#.......#..#.#..................#.#......#.....................
..........##....##....#......##.......#...........#............#.......###.......##..#.#.#..#....#...#.........#.###.#.#...........
.................#.#..........#...#...#........#........#..###..............#....#............#.........#.......#.#....##..........
.##...............................#..#.#.......#...#....#...#............#......#........#....#.#....#..#.......#..#...............
................#..................#.......###..#..........#.#.................#..##......##.#........#......####..................
.....#...............................#..#.#.#....#.#............#....#....................##....#..............................#...
..#............#.#...#...........#.........#......#.................##.#...#.......................##..#...........................
................#......#....#...##..#........##..#.##..#.......#........#..........#................#..............................
.................................#..###..........#.....##............##.....##.......#.#.#....#..#.............#..#............#...
..#...#..............#............###...........#.#.#.#..#....#.#..#...#.....#..........................#....#...........#.#..#..#.
.#.###...#........#..............#.#........#.......#.......#.........#.....#...#..###...##..##..#....#.#......#.........#......#..
..........#.........#.......#..##.#.....#.##..#.........#..#...#.....#.#.##....#.........#.#.....#......#..............#...#.......
..#..#..#...#.........#..##...#..#...#......#.............#.#.........#.#...##.....#.....#...#..#.....#..##...........#........#...
..#....#....#................###...#......#.....#..#....#..........#.........#.#..#.................#.#..#............#.....##..#..
....#.......##........##...#..##........#........#..##............#.........#..##...#.....#..#...#.......#.............#........#..
.#...#...##.............#........##...#.....#.##....#...#.....#..........##..............#................................##.#.#...
.....#.......##.........#.....#.....#..#.###..#......#......##..............#................#..##..................##......###..#.
.##...####.......#..........#.........#...#........................##....#......#.......#........#.....#.........#..........#.#....
..................#...........#..#.....#..#........#...................#............#..........#..#.#...........#.#....#....#......
........#..#....................................#..................#.#................#..#....#.#.......................#....#.....
.#..............##..............##.##....##..##...#...##......##......#......#..........#....#..................................#..
.#....#.....#....##..............#.##..##...#.......#.##.......##..#.............#.#.....#...#......#............#..........##.....
..................##............#...##.................#...#.##...#.........#....#....#....#..#.....#........#..........#...#.#..#.
.##.......#........#.#.........#......................#.#..#.#........#.....................#.#.............###........#.#.........
.#..........#....#.....#...........#....#..........###................#.#.#...#.##......#...................#....#.....#.......#...
...#....#..#..#.......#.#..............#........#........###.#.....#....#...#.....##.......................#....#...........#....#.
..#.................................#.....###......#......##...#...#.......#............##.....#........#.#........................
.#...........#....#......#.......................#........##........#.........#.....#.....#....#............###..#...#.#....#......
.......#.#......#.#....................#.##................#.#...........#...........#.#...##........................#.............
....#......#....#.......#.....................#.#..#........#..........#..#..#.......#.#..............#......#..............#......
.....#......#.......#....................#.......#..#...####.##....#...#.#.......##...#.#...........#..............#..........#....
..#.........#........##....#.............##.#.#.........#....##........#..#........................#...#.#..#....#.................
.#....#..#.##.......#..#..#...##............##.##..#..#......#.##.......#.................#......................##.....#........#.
..................#.........#............#...##......................#...............#...........#................#.....#....#.#...
..#......##............#.......#.#................#.....#..........................#..#...................#....#....#.........#....
.#.#........#....#..##..#.....#.#...............#.......##..#.........#.....#........#...............##............................
..#.........##...................#.#........##......#.#.......##......##.#..#....#.#.#...........#..##...................#.......#.
....#.#.##.....###..#..........#....#..............#.###....#......##.............##...........#........#...........#...........##.
.#...##..#......##....#........##.#..............#.......##..#.....#....##.....................#...##..#............#..........#...
....#...#..........#...........#.#.#..............##.#.#.....###..................#.............#....#.....####....................
........#..#.........###........................#.#..#..........#.............................#...#......#.............##..........
.....#...#.............#.....#....#...#..............##.##........#..#...##.....#...............#..............#....#...#....#.....
....#.#...........#...#.##.....##....#.#...........##....#.....#...............................#.#.#...#.....#..#........#.........
...##...........................##..##.................##....#........#.....#...........#....#.....#............##.......#.........
............#.....#.....#......##...........................................#.........#.....#......#............#........#.#.#.....
......##...#....#...#...#.......#...........................#..#...#.#................#..........#...#.##..........#....##.#.......
.....#...#.#..###.#.#.........#.#..........#...........#.....#.............................#..#.#....#.#.....#.....#..#......#.....
.#.....#...#....................#...............................#.....#.............#.##.....####..##.....#.###....#..#............
....#...#.............#.#....#.....#..#..#...#.............#.......................#.#........#..#...#.................#...#.#...#.
..........#..#...#.....#..........#...#....#.#.....................#............................#....#.#......#.#.............#....
..##.....#...#......#.#....#....#.##.#....#......#........##........#...........#..#........#......#.#.....................#.#.....
......#...####.......#......#..##..###.......#...............#........#.........#....#.#.............##........##..#.#......#......
....##.##..........#.#.#.#.#..#.....##......................#.....#.#......................#....#.................#...........#....
.......#..##.#.#..##...#...........................#............................#....##.......#........#......#..........#.#.......
.....#.##.......#................#...#........#...#.............................#..#........#......###.###....#...##.............#.
.......#............##..........##..#.#.....#...................#................................#..#...#...#........#....#......#.
.#.#.#.#..#...#...........#.#.....#...................#.#......................#......##.....#..................#...##..#.#........
............#...............#...#........##....#..#...........................#.#..#.....#.##.................#...#....#......#....
.....#.......#.............................#......#..#.#..#.....................#...........#...#........#.#........#....#.........
.#.##..#............#..#.................................................#...#..###................##........##.#..#......#......#.
.........#...............##......#............#.....#...........................#.............##.#.#.#.......###.....#..........#..
...................................................................................................................................